        #######                           
        #.....#                           
        #.....#                           
        #.....#                           
        #.....#                           
        #.....#                           
        #######                           
                                          
                 #########                
                 #.......#                
                 #.......#                
                 #.......#                
                 #.......#                
                 #.......#                
                 #.......#                
                 #.......#                
                 #########        #####   
                                  #...#   
                                  #...#   
#####                             #...#   
#...#                             #####   
#...#  ############                       
#...#  #.....##...#                       
#...#  #.....##...#                       
#...#  #.....##...# #######        #######
#####  #.....###### #.....#        #.....#
       #.....#      #.....#        #.....#
       #.....#      #.....#        #.....#
       #.....#      #.....#   ######.....#
       #######      #.....#   #...##.....#
                    #.....#   #...########
                    #.....#   #...#       
                    #######   #...#       
                              #...#       
                              #####       
                                          
                                          
                                          
              #######                     
              #.....#                     
              #.....#                     
              #.....#                     
              #######                     
