####  #
#     #
#     #
#     #
#     #
#     #
#     #
#     #
#     #
#######
