               #####                                
               #...#                                
               #...#                                
               #...#                                
               ##.##                                
                #.#                                 
                #.#                                 
                #.#                                 
                #.#                                 
              ###.###                               
              #.....#                               
              #.....#######    #######              
#####         #............#   #.....#              
#...###########.....######.#   #.....#              
#...................#    #.#####.....#              
#...#################    #...........#              
#####                    #.#####.....#              
                         #.#   #.....#              
                         #.#   #.....#              
                         #.#   #######              
                        ##.##                       
                        #...#                       
                        #...#                       
                    #####...########                
                   #................#               
                   #.####...#######.#               
                   #.#  #...#  ####.####            
      #######      #.#  #...#  #.......#            
      #.....#      #.#  #####  #.......#   #########
      #.....#      #.#         #.......#####.......#
      #.....#      #.#         #...................#
      #.....########.##        #.......#####.......#
      #...............#        #########   #.......#
      #############...#                    #.......#
              #####...#                    ###.#####
             #........#                      #.#    
             #.####...#                      #.#    
             #.#  #...#                      #.#    
             #.#  #...#                  #####.###  
             #.#  #####           ########.......#  
#######      #.#                 #...............#  
#.....#      #.#                 #.#######.......#  
#.....#   ####.####           ####.####  #########  
#.....#####.......#           #.......#             
#.................#           #.......#             
#.....#####.......#           #.......#             
#.....#   #####.###           #.......#             
#.....#       #.#             #.......#             
#######       #.#             ###.#####             
              #.#               #.#                 
              #.#               #.#                 
              #.#               #.#                 
              #.#            ####.##                
              #.#            #.....#                
              #.#            #.....#                
             ##.##           #.....#                
             #...#           #.....#                
             #...#           #.....#                
             #...#           #.....#                
             #...#           #.....#                
             #...#           #######                
             #####                                  
