                              ###########                   
                              #.........#                   
                              #.........#                   
                              #.........#                   
                              #.........#                   
             ###########      #.........#                   
             #.........#      ###########                   
             #.........#                                    
             #.........#                                    
             #######.###                                    
                   #.#                                      
                   #.#                                      
                ####.####                                   
                #.......#                                   
###########     #.......#                 ###########       
#.........#     #.......#                 #.........#       
#.........#     #.......#                 #.........#       
#.........#     #.......#                 #.........#       
###########     #.......#                 #.........#       
                #.......#                 #.........#       
                #.......#   #########     #.........#       
                #.......#   #.......#     #.........#       
                ###.#####   #.......#     #.........#       
                  #.#       #.......#     #.........#       
                  #.#       ####.####     #.........#       
                  #.#          #.#        #.........#       
                  #.#          #.#        ####.######       
         ##########.##         #.#           #.#            
         #...........#         #.#           #.#            
         #...........#    ######.####     ####.####         
         #...........#    #.........#######.......#         
         #...........#    #.......................#         
         #...........#    #.........#######.......#         
         ########.####    #######.###     #########         
                #.#             #.#                         
                #.#             #.#                         
                #.#           ###.#########                 
             ####.########    #...........#                 
             #...........#    #...........#                 
             #...........#    #...........#                 
             #...........#    #...........#                 
             ####.########    #...........#                 
                #.#           #...........#          #######
                #.#           #...........#          #.....#
           ######.####        #...........#          #.....#
           #.........#        #...........#          #.....#
           #.........#        #...........#          #.....#
           #.........#        #...........#          #.....#
           #.........#        #############          #.....#
           #.........#                               #.....#
           #.........#                               #######
           #.........#                                      
           #.........#                                      
           #.........#                                      
           ###########          #####                       
                                #...#                       
                                #...#                       
                                #...#                       
                                #...#                       
                     #########  #...#                       
                     #.......#  #...#                       
                     #.......#  #...#                       
                     #.......#  #...#                       
                     #.......#  #...#                       
                     #.......#  #####                       
                     #########                              
