3###1#       
#....#       
#....####.###
#....X......#
#....#......#
###2##......#
     #......#
     #1#####2
