                    #############                         
                    #...........#                         
                    #...........#                         
                    #...........#                         
                    #...........#                         
                    #...........#                         
                    #...........#   #############         
                    #...........#   #...........#         
                    #...........#   #...........#         
                    #...........#   #...........#         
                    ###########.######.########.######    
  ###########                 #........#      #.......    
  #.........#                  #######.#       #########  
  #.........#                        #.#           #...#  
  #.........#                     ####.##          #...#  
  #####.#####                     #.....#          #...#  
      #.#                         #.....#          #...#  
      #.#        #######         #......#          #...#  
#######.#####    #.....#         #......#          ##.##  
#...........#    #.....#         #......#           #.#   
#...........#    #.....#         #.######           #.#   
#...........#    #.....#         #.#                #.#   
#...........#    #.....#       #####         ########.####
#...........#  #.#.....##.#    ....#         #...........#
#########.###  #.#.....##.#    ####          #...........#
        #.#    #.#.....#########             #...........#
        #####  #.#.....##.......####         #######.#####
        #....#####.....# ###.......#               ####   
         ###.....#.....#   #.......#               #...   
          #...##########   #.......#                ##### 
          #...#            #.......#                #...# 
          #...#            #.......#                #...# 
          #...#            #######.####             #...# 
          #...# #.#              #.....             #...# 
          #...# #.#               #####             #...# 
          #...# #.#                #######          #...# 
          #...# #.#                #.....#          #...# 
          #...# ########           #.....#.#        ##### 
          ##### #.......           #.....#.#              
                 #######           #######.#              
                                         ######           
                                         #.....           
                    #######               #########       
                    #.....#               #.......#       
                    #.....#               #.......#       
                    #.....#               #.......#       
                    ###.###               #.......#       
                      #.#                 #.......#       
                      #.#                 #.......#       
                  #####.#####             #.......#       
                  #.........#             #########       
                  #.........#                             
                  #.........#                             
                  #.........#                             
                  #.........#                             
                  #.........#                             
                  #.........#                             
                  #.........#                             
                  #.........#                             
                  ###########                             
