#####.####
#........#
#........#
.........#
#........#
.........#
#........#
#........#
##########
